M M M M M M M M M M M M M
M _ _ _ _ _ _ _ _ _ _ _ M
M _ _ _ _ _ _ _ _ _ _ _ M
M _ _ _ _ _ _ _ _ _ _ _ M
M _ _ _ _ _ H _ _ _ _ _ P
M _ A M _ _ _ _ _ _ _ _ M
M _ M M _ _ _ _ _ _ _ _ M
M _ _ _ _ _ _ _ _ _ _ _ M
M M M M M M M M M M M M M